1111111111111111111111111111111111
1E0C10000000000C00000C000000000001
1101000100100000101001000C00010101
1100010010101010001001C00000010101
100011100C00C000C000000000000010C1
1P0001100C10C00000000C000C000010C1
1111111111111111111111111111111111