1111111111111
1E0100C0000C1
110C011111001
1P0011C00C001
1111111111111